9 11
WWWWWWWWWWW
WEEEEEEEEEW
W---------W
WEEEE-EEEEW
W---------W
WEEEE-EEEEW
W---------W
WEEEE-EEEEW
WWWWWGWWWWW
